################################
#@      GET TO THE GOAL        #
#   +                          #
#     #####    ?               #
#   +     #                    #
#         #                    #
#         #                    #
#         #                    #
#                              #
#                              #
#                              #
#                              #
#                              #
#                              #
#                              #
#                              #
#                              #
################################
