################################
#@      GET TO THE GOAL        #
#   +                          #
#     #        ?               #
#                              #
#                              #
#                              #
#                              #
#                              #
#                              #
#                              #
#                              #
#                              #
#                              #
#                              #
#                              #
#                              #
################################
