################################
#@      GET TO THE GOAL        #
#   +                          #
#     #####                    #
#   +     #    ?               #
#         #                    #
#         #                    #
#         #                    #
#                              #
#                              #
#                              #
#                              #
#                              #
#                              #
#                              #
#                              #
#                              #
################################
