################################
#@      GET TO THE GOAL        #
#   +                          #
#     #####    ?               #
#   +                          #
#                              #
#                              #
#                              #
#                              #
#                              #
#                              #
#                              #
#                              #
#                              #
#                              #
#                              #
#                              #
################################
