##############################################
##                                          ##
##                 LEVEL 4:                 ##
##              Without Signal              ##
##                                          ##
##                                          ##
##        @                    ?            ##
##                [][][][][]                ##
##                        []                ##
##                        []                ##
##                   +    []  +             ##
##                        []                ##
##############################################
