##############################################
##                                 []       ##
##         LEVEL 6:                []       ##
##      Long Way Around                     ##
##                        [][]---[][]       ##
##                        []-------[]       ##
##    +   ?               [] +     []       ##
##----------[][][][][][][][]   ##  []       ##
##        @                    ##  []       ##
##                             ##  []       ##
##                             ##        +  ##
##                             ##[][]       ##
##############################################
