##############################################
##                                          ##
##                 LEVEL 1:                 ##
##              Reach the goal              ##
##                                          ##
##                    +                     ##
##                                          ##
##          @                  ?            ##
##                                          ##
##               W                          ##
##              ASD  to move                ##
##                                          ##
##############################################
