##############################################
##                                          ##
##                 LEVEL 5:                 ##
##                  Glass                   ##
##        ?                                 ##
##-------------------------------------     ##
##        @                                 ##
##            [][][][][][][]                ##
##                        []                ##
##                        []                ##
##        +               []     +          ##
##                        []                ##
##############################################
