###############################
#                             #
#          LEVEL 3:           #
#       Losing Signal         #
#                             #
#      ################       #
#       @  #     # ?          #
#          #     #            #
#            ###              #
#             #               #
#             +               #
#                             #
#                             #
###############################
