[][][][][][][][][][][][][][][][][][][][][][][]
[]                                          []
[]                 LEVEL 1:                 []
[]              Reach the goal              []
[]                                          []
[]                                          []
[]          @                  ?            []
[]                                          []
[]                                          []
[]                    +                     []
[]                                          []
[]                                          []
[][][][][][][][][][][][][][][][][][][][][][][]
