###############################
#                             #
#          LEVEL 2:           #
#         Obstacles           #
#                             #
#             #               #
#        @    #    ?          #
#             #               #
#                             #
#        +         +          #
#                             #
#                             #
###############################
