##############################################
##                                          ##
##                 LEVEL 3:                 ##
##              Losing Signal               ##
##                                          ##
##                        ##                ##
##        @         uh oh ##   ?            ##
##                        ##                ##
##                [][][][][]                ##
##                                          ##
##                  +                       ##
##                                          ##
##############################################
