##############################################
##                                          ##
##        +                        +        ##
##                                          ##
##              CONGRATULATIONS             ##
##                                          ##
##                    @                     ##
##                                          ##
##              A WINNER IS YOU             ## 
##                                          ## 
##                    +                     ##
##                                          ##
##############################################
